5555555555555555555555555555
5000000000000000000000000005
5000000000000000000000000005
5000000000444444440000000005
5000000000422222240000000005
5000000000422222240000000005
5110011000444224440001100115
5110011000004224000001100115
5001100000004444000000011005
5001100000000000000000011005
5000000004400000044000000005
5000000005400000045000000005
5000000005441111445000000005
5001155555441001445555511005
5001100005441111445000011005
5001100005444444445000011005
5001100004444444444000011005
5000000004444444444000000005
5000000004441111444000000005
5000000004441111444000000005
5222000052222112222500002225
5222000052222112222500002225
5000000044422222244400000005
5000000044444444444400000005
5000000044441111444400000005
5440000044001901444400000445
5440000044001001444400000445
5555555555555555555555555555